
  
YR WYTHNOS. 12.30pm bob pnawn Sul ar S4C. 
Yr Wythnos yw rhaglen BBC Cymru ar gyfer S4C sy'n edrych yn ôl ar storiau newyddion y saith diwrnod diwethaf. 
Gallwch wylio Yr Wythnos ar y dudalen hon yn fyw bob dydd Sul ac am wythnos gyfan wedyn. 
Cliciwch yma i weld recordiad o'r rhaglen ddiweddara'. 
Mae'r Wythnos yn addas ar gyfer pobol sydd wrthi'n dysgu Cymraeg. 
  Y cyflwynydd: Gwenllian Grigg 
Hefyd mae'n ddelfrydol ar gyfer y rhai sydd wedi colli rhai o storiau mawr yr wythnos. 
Bydd geiriau anodd yn dod ar y sgrîn, a bydd y geiriau hynny ar y dudalen hon ar ôl pob rhaglen. 
Os byddech chi'n hoffi derbyn sgriptiau Yr Wythnos ar e-bost, rhowch eich cyfeiriad e-bost yn y blwch yma.
 
* Fe fydd y sgriptiau yn cael eu hanfon ar brynhawn Sul wedi'r rhaglen.
Mae geirfa newyddion yn nhrefn yr wyddor ar gael drwy glicio yma 
Ac mae geirfa yn ôl pwnc ar gael drwy glicio yma 
CWIS - Ar ôl darllen yr eirfa, cliciwch yma i geisio ateb cwestiynau syml. 
GEIRFA Yr Wythnos, yr 30ain o Hydref 
olion - traces 
gwasanaethau brys - emergency services 
gor-wyr - great grandson 
archwiliadau - examinations 
ffrwydradau - explosions 
newyddiadurwyr - journalists 
tystiolaeth bellach - further evidence 
delw - statue 
pibell nwy - gas pipeline 
Bannau Brycheiniog - Brecon Beacons 
claddu - to bury 
iawndal - compensation 
garw - rough 
amaethu - to farm 
tirlun - landscape 
achosi marwolaethau - to cause the deaths 
trais - violence 
cynhyrchu - to manufacture 
sylweddoli - to realise 
cais - a try 
camp lawn - grand slam 
pwl - a bout 
hyfforddi - to train 
arddegau - teenage years 
gwahardd - to ban 
rhydd - free 
mewnforio - to import 
awdurdod safonnau bwyd - food standards agency 
hwyaden - duck 
trafodaeth - debate 
cyflwr - condition 
gwaedu mewnol - internal bleeding 
cyhoeddus - public 
croesawu - to welcome 
cydfynd - to agree 
cynlluniau - plans 
ewyllys - will 
carfan - squad 
anafiadau - injuries 
haeddu - to deserve 
canmlwyddiant - centenary 
Gweilch - Ospreys 
cytundeb - contract 
elw - profit 
nwyddau - goods 
cynghreiriau - leagues 
lloeren - satellite 
gwrthod - to refuse 
cymal - clause 
chwyldro diwydiannol - industrial revolution 
haearn a glo - iron and coal 
balch - proud 
beirniadu - to criticise 
ar gynnydd - on the increase 
Ceir mwy o ddeunydd i helpu chi ar safle dysgu Cymraeg drwy glicio yma. 
